██████████████████████████████████████████████████████████████████████████████████████████████████████████████████████████████████████████████
████    ██          ██                          ██          ██                  ██                  ██              ██                  ██  ██
██████  ██  ██████  ██████  ██████████████████  ██  ██████████  ██  ██████████  ██  ██████████  ██  ██  ██████  ██████  ██████  ██████  ██  ██
██  ██  ██      ██          ██  ██              ██              ██  ██      ██  ██  ██      ██  ██  ██      ██  ██          ██      ██      ██
██  ██  ██  ██  ██████████████  ██  ██████████████████████  ██████  ██  ██  ██████  ██████  ██  ██  ██████████  ██  ██████████████  ██████  ██
██      ██  ██  ██              ██      ██              ██      ██      ██                  ██  ██          ██      ██  ██      ██  ██  ██  ██
██  ██████████  ██████████████  ██████  ██  ██████████  ██████  ██████████████████████████████  ██████████  ██  ██████  ██  ██  ██  ██  ██  ██
██          ██              ██              ██      ██      ██  ██          ██                  ██      ██  ██  ██      ██  ██      ██  ██  ██
██████████  ██████████████  ██████████████████  ██  ██████  ██  ██████  ██████  ██████████████████  ██  ██  ██  ██  ██  ██  ██████████  ██  ██
██      ██              ██  ██      ██      ██  ██          ██          ██      ██              ██  ██  ██  ██      ██  ██      ██          ██
██  ██  ██████████████  ██  ██  ██  ██████  ██  ██████████████████████████  ██  ██  ██████████  ██  ██████  ██████████████████  ██████████████
██  ██      ██          ██      ██      ██          ██          ██          ██  ██  ██          ██      ██                  ██              ██
██  ██████  ██  ██████████  ██████████  ██████████  ██  ██████  ██  ██████████████  ██  ██████████  ██  ██████████████████  ██  ██████████  ██
██  ██  ██      ██      ██          ██  ██      ██      ██      ██                  ██          ██  ██      ██              ██  ██          ██
██  ██  ██████████  ██  ██████████  ██  ██  ██  ██████  ██████  ██  ██████████████████████████  ██  ██  ██████  ██████████████████  ██████  ██
██  ██              ██      ██      ██      ██      ██  ██████  ██      ██████████████          ██  ██              ██          ██      ██  ██
██  ██████████████  ██████  ██  ██████████████████  ██  ██████  ██████████████████████  ██████████  ██████████████  ██  ██████  ██████  ██████
██      ██      ██  ██  ██                  ██  ██  ██  ██████                  ██████      ██      ██      ██  ██  ██      ██      ██      ██
██████  ██  ██  ██  ██  ██████████████████  ██  ██  ██  ██████████████  ██████████████  ██  ██████████  ██  ██  ██  ██  ██  ██████  ██████  ██
██  ██      ██  ██      ██              ██      ██  ██  ██████████████  ██████████████  ██              ██  ██      ██  ██      ██          ██
██  ██████████  ██████████  ██████████  ██████████  ██████████████████  ██████████████  ██████████████  ██  ██  ██████████████  ██████████  ██
██      ██      ██      ██      ██  ██          ██      ██      ██████  ██████          ██          ██  ██  ██  ██              ██  ██      ██
██████  ██  ██████  ██  ██████  ██  ██████████  ██████  ██████  ██████  ██████████████████  ██████  ██████  ██  ██████  ██████████  ██  ██████
██      ██          ██          ██          ██          ██      ██████  ██████████████      ██  ██  ██      ██      ██      ██      ██      ██
██  ██████████████████████████████████████  ██████████████  ██████████  ██████████████  ██████  ██  ██  ██████████  ██████  ██  ██  ██████  ██
██              ██      ██              ██          ██              ██  ██              ██  ██      ██  ██      ██          ██  ██          ██
██████████████  ██  ██  ██  ██  ██████  ██████  ██  ██  ██████  ██████  ██  ██████████████  ██  ██████  ██  ██  ██████████████  ██████████████
██              ██  ██      ██      ██      ██  ██  ██      ██  ██      ██      ██      ██      ██      ██  ██      ██          ██          ██
██  ██  ██████████  ██████████████  ██████  ██  ██  ██████  ██  ██  ██████  ██  ██  ██  ██  ██████  ██  ██  ██  ██  ██  ██████████  ██  ██  ██
██  ██  ██          ██          ██      ██      ██  ██  ██  ██  ██  ██  ██  ██      ██  ██  ██      ██  ██  ██  ██  ██          ██  ██  ██  ██
██  ██████  ██████████  ██  ██  ██████  ██████████  ██  ██  ██  ██  ██  ██  ██████████  ██  ██████████  ██  ██  ██████████████  ██████  ██  ██
██  ██      ██      ██  ██  ██      ██  ██          ██      ██  ██  ██      ██      ██  ██  ██          ██  ██                  ██      ██  ██
██  ██  ██████  ██  ██████  ██████████  ██  ██████████████████  ██  ██  ██████  ██  ██  ██  ██  ██████████████  ██████████████████  ██████  ██
██  ██  ██      ██      ██      ██      ██  ██                  ██  ██  ██      ██      ██  ██      ██      ██          ██          ██      ██
██  ██  ██  ██████████  ██████  ██  ██████  ██████  ██████████  ██  ██████  ██████████████  ██████  ██  ██  ██████████  ██  ██████  ██████████
██      ██  ██      ██  ██      ██      ██  ██      ██          ██  ██      ██  ██      ██      ██      ██          ██  ██      ██          ██
██  ██████  ██  ██████  ██  ██  ██████  ██  ██  ██████████████████  ██  ██████  ██  ██  ██████  ██████████████████  ██  ██████  ██████████  ██
██          ██      ██      ██  ██  ██  ██      ██      ██      ██      ██          ██          ██      ██          ██  ██      ██          ██
██████████████  ██  ██████████  ██  ██  ██████████  ██  ██  ██  ██████████  ██████████████████████  ██  ██  ██████████  ██████████  ██████  ██
██              ██                  ██              ██      ██                                      ██      ██                      ██    ████
██████████████████████████████████████████████████████████████████████████████████████████████████████████████████████████████████████████████
